####################################
#########                ###########
#####          O            ########
##                                ##
#                                  #
###########             ############
#                ###################
#  X                ################
#                       ############
#                           ########
###############                    #
#########                        ###
###                        #########
#                    ###############
#              #####################
#   P      #########################
#       ############################
####################################
