**X*X***X*****X**X***X****X********X*********X*********X********X**X****X******X*****X*****X*X*****X
X*X***X**X*XX**X*X*X***XX*X*XXXX*X**XXXXXX*X**X*XXXX*X*X*X*XXXX*XX*X*X*X**XXXX***XX*X**X*X***X*XX*XX
X**X*X**X**X*X*X*X**XXX*X***X**X*X*X*****X**X**X*****X****X***X**X*X*X*X*X****X*X****X*X*XXX*X**X**X
**XX*X*X**X**X*X**X***X**XXX**X**X*X*XXX*X*X*X*X*XXXX*XXXX**X**X*X*X*X***X*X*X**XX*X**XX***X**X*X*XX
X****X***X**X**XX**XX**X*****X*X*X*X*X*X***X***X*X**X******X*XX**X*X**X*X**X**X***X*X*X**X*X*X**X**X
*X*XX*XXX**XX*X*XX***X**X*X*X****X*X*X**XXX*X*X**X*X**XXX*XX***X*X**X*XX*X**X**XX*X*X**X*X**XX*X**X*
**X******X****X****XX**X**X**XX*XX*X*X*X****X***X**X*X**X*X**X*X*X*XX*****XX**X***X***X***X*X**XX***
X*X*XX*XXX*XXX*XXX**X*X**XX*X***X**X*X***X*X*XXX*X***XX*X***XX***X****X*X**X*X**XX**X*X*X*X***X**XX*
**X*XX*****X******X*X*X*X***X*XX**X***X*XX***X***X*XX****XXX**XXX*X*X**X*X***X*XX**X*X***X*XXXX*X***
X*X***X*XXX*X*XXX*X***X*X*X*X**X*XXXX*X*X*X*X**X*X****X*X***X******X**X***XXXX*X**XX***X***X****XX*X
***XX**X******X*X*X*XX**X*X**X*X**X***X***X***XX**XXXX**X*X**X*XXX*X*X**X******XX***X*X*X*X**X*X***X
*X***X**X*XX*X**X*X**X*X***X*X**X***XX*XX**XXX**X*X**X*XX**X*X***X*XX**XXXXX*XX**XX**X*****X*X*X*X**
**XX*XX*X**X**X*X**X**XX*XX**XX**XXX*X****X***X*X***X****XX***XX*X****XXX***X***X**X*XXX*X*X*X*X*XX*
X*X***X**X*X*X***X**X****X**X**X*X***X*X*X**X***XX*X*XXX****X**X*XXX*X*X**X*X*X***XX****X**XX**X**X*
**X*XXX*X**X*X*X**X**XX*X**X*X*X*X*X*X**X**XXX*X***X****XXXX*X*X****X****X****X*X***X*X**X****XXX*X*
X*X*X***X*XX*X**X**X***X*X*X***X*X*X**X**X**X**X*X*X*XX****X***X*XX*X*XX*X*XXX***XXX*X*X**XXX**X**X*
**XX**XX**X***X*X*X*XX*X*****X*X*X**X**X**X**X*X*X*X**XX*XX**XX*XX**X**X**XX***XX*******X***X*X**X**
X***X*X*X*X*XX**X****X*X*XXXXX*X**X**X**X**X*X*X*XX*X**X*X**XX*****X*X*XX***X*X*X*XXX*X**XX*X*X*XX*X
X*X*X****X**X**X**X*X**XX*****X*X*XXX**X*X**X**X****XX*X***X***XXXX**X***XX*X***X***X*XX*X**X*X*X**X
**X**XXX*X*X**X*X**X**X***X*X*X*****X*X**XX**X**XXX**X**XX**X*X****X**X*X***XX*X*XX*X***X**X**X*X*XX
*X**X****X*X*X**X*X**XX*XX*XX*X*XXX*X***X***X*X***XX*XX*X*XX***X*X*XX****XX***X***X**X*XX*X**X**X**X
**X***X*X**X*X*X**XX****X*****XXX***X*X*X*XX**X*X**X**X*X****X***X***XXX**XX*X**X***X**X**X*X**X*X**
*X*XXX*X**X*****X***XXXX*X*XXX****XX**X*X*X*X***XX**X***X*XXX*X*X**X****X**X*X*X*XXX**X**XX*X*XX**X*
*X******X*X*X*XX*X*X***X*X*****XXX*X*XXX**X**XX***X**XXX**X****X*X*X*XX**X*X*X******X***X***X***X*X*
*X*XXXX*X**XXX***X***X*X**XX*XX*******X**X*X***XX*XX****X*X*XX****X***XX*X*X**XXXX*X*XXX*XXXX*X*X***
***X**X**X**XX*X*X*XX***X*X*X***X*X*XXX*X**X*X*****X*XX**X**XXXXX*X*X**X*X**X*X****X*********XX*X*X*
X*X*X*XX*XX****X*X*X**X*****X*X**XXX****X*XX**XXXXX**X*X***X*X**X**X*X*X**X*X*X*XXX**XXXXXXX****X*X*
**X****X**XX*XX**X**X**XXXX*X**X**XX*XXX**X**X****X*XX**X*X****XXX*X***X*XX*X***X***X******X*XXXX**X
*X**XX**X***X***X**X**X***X**X**X****X**X***X*XX*X**X**X*X**X*X*X**X*XX**X***XXX**XX*X*X*X**X*****XX
X**X**X**XX*XX*XXX*X*X**X**X*X*X*X*XX*X*X*XX*****X*X**X****X**X***X*X***XX*XX****X***X**X*X**X*XXX*X
**XX*XXX**X**X**X***X**X**X**X****X***X***X**XX*XX*X*X*XX*X*X*X*XX****XX******XXX**X*X*X***X*X******
*XX***XXX**X***X**X*X*X*X***X*XXX**XX***X**X*X**X**X*X****X*X****X*XX*XX*XXXXX**X*X**X***X*X**XX*XX*
*X**X**X*X**XX*X*X**XX***X*X*****X***X*X**X**X*X**X**X*XXX***XXXX***X***XX****X*X**X**XXX**X*X**X***
***X*X*X**X***X**X*X***X*X*X*X*X**XX**X**XXX*X*X*X**XX****X*X****XX*XXX***XX*X**X*X*X****X*X**X***X*
XXX****X*X*X*X**X**X*XX**X**X**X*X**X**X**X**X*X*XX***X*X*X***XX*X*X***XX*X****XX****XXX****X*X*XX*X
****XXXX***X***X**X**X**X**X**XX***X*X**X*X*X**X**X*X*XX***X*X***X***X**X*X*X*X***XX*X**XXX*X*X*X***
*X*XX***X*X*XXXXX*X*X*X*X*X**X**X*X**X*X***X**X*X*X*X****X*X*X*XX*XX**X***X*X**X*X***X*XX**X**X**X*X
**X***X***X****XX***X*X*X**X*XX*X***X**X*X*X*X**X**X**XXX*X**X**X***X**XXXX**X**X**XXX***X*X*XXX*X**
X**X*X*XX*X*XX***X*XX*X**X*X*****XX*X*X*X**X***XXX*X*X******X*X***X***X****X**X***X****X***X**X**XX*
*X***X**X*X*X*XX*X****X*XXX*XXXX*XX***X**X***X**XX*X**X*XX*X**XXXX*X*X**XX**X**XXX*X*XX**XX**X**X***
**XXX**X****X**X**XX*X**XX*****X***XXX*X**XX*X*X***XX**X***X*X******X**X**X**X*****X*X*X**X*X**X**X*
*X****X*XXXX**X*X**X*X*X***XXX**XX***X**X**XX**X*XX*XX*XX*X**X*XX*X**X***X*X**XXXX***X***XX*X*X**X**
***XX*******X****X**X**X*XX***X**XXX*X*XXX****XX*X***X**X**X*X*X**X*X*XX***X*X****XXX**XX***X***X**X
*XX**XXX*XX***XX**X**X***X**X**X***X*X**X*X*XX***X*X**X*X*XX***X*X****X**X*X*X*XX***XX*X**X**XXX*X**
*X**X***X*XXX***X**X**X*X**XX*X*X*X***X****X***XX***X*X*X*X**XXX**XXXX**X*XX*X*X*XX*****X*X*X**X**X*
**X***X*X****XX*X*X**XXX**XX****X**X*X*X*X*X*X*X*XXX**X***X*X***X*X****X*****X***X*X*XX*X*X*XX***XX*
X*XX*X**X*XX**X*XXX*X*X**XX**X*X**X**X***X*X*X*X*****X*XXX**XXX*X*X*X*XX*XXX*X*X*X**X*X*X*X**XX*X***
X**X*X*XX**X*XX*****X*X*X***XX*X*XX*XX*XXX**X**X*X*X*X***X*X****X****X***X****X**XX****X**XX****X*XX
*X***X*X*X*X***XXX*X****X*XX***X****X**X**X***X**XX****X*X**X*X**X*X*X*XX*X*X**X***X*X*X*X**XX*X**X*
*X*XX**X***X*X*X**X*XXX*X**X*X**XXXX**X*X**XXX**X***XXX**XX***XX**XXX**X**X*X*X*XX*XX**X**X*****X***
**X***X**XX**X**X******X*X**X*X*X****X**X*X**XX**X*X***X***XXX*XX**X**X**X***X***X***X**X*X*X*X**X*X
X***XX**XX**X*X*XX*XXX****X*X*X*XX*XX*X*****X***X**X*X**XX***X***X*X*XXX*X*XX**X*XXX**X*X*X*XX*X*X*X
**XX***X***X**X**X*X**XXX*X*X*X**X****XX*XX*X*X**X*X**X***XX**XX*X*X**X**X*X**XX****X***X*X****X*X**
*X**XXXX*XX**X*X*X**X***X*X*X**X**X*X**X***X**X*X***X*XXX**XX****X**X**X****X***X*X*X*X*X*X*X*X***X*
**X******X*X***X*X*X**X***X*X*X*X*X**X*X*XXX*X***XX*X****X***X*X*X*X*X*X*XXX*XX**X***X**X*X**X**XX**
*X**X*XXX****XX**X*X*XXXXXX*X***X*X*X**X******XX*X**XXX*X*XX*X**X****X**X*****XX**XX*X*XX**XX**XX**X
***X*X****X*XX**XX*X**X*****X*XX**X**X**X*XXX**X**X***X****X**X**X*X**X***X*X**XX**X*X***X*X**XX**XX
XXX**X*X*X**X**X***XX**X*X*X**X**XXX*XX*X***XXX*X*X*X**XX*X*X**X*X**XX*XXX***X***X*X**X*X**X*XX**XXX
***X*X**X*X***X*X*X*X*X***X**XX*XXX***X*X*XX****X*X**XX*****X*X***X*******X*X*XX*X*X*X**X*XXXX**X*XX
XX****X*X**XXXX***X*X***XX**X***XX**XX**X**X*XX***X*X***XX*X**X*X**X*XXXX*X*****XX*X*X*X***X***X***X
***X*X**XX*X***XX*X**XXX***X*X*X***XX**X**X**X*X*X**X*XX**X**XXX**X*X*****XXX*X*X**X***XX*X**XX*XX*X
*XX**X*X*****X*X***X****X*X**X**X*X***X**X*X*X**X**XX*X*X**X*XX**X****XXXX***X**X*X*XXX*X*X*XX******
***X*X**XXX*X**X*X**X*X*****X*X**X**XX*X*X*X*X*X**X***X**X*X***X*X*XXX***X*X*XX*X*****X*X*X***XX*XX*
X*X**XX*X***X*XX**X**X**X*XX***X*X*X***X*X*X*X**X*X*XX*X****XX**X**X***XX**X*****XX*XX**X**XX**X**X*
**XX**X*X*XXX***XX**X**XX**X*X*X*X*X*X*X*X*X*X*X**X**X**X*X***X***X*XX*X**X*XXXX*XX****X*X*X**X**X**
*X***X**X*X**XX***X**X***X***X*X***X*X*X***X*X***X*X**X***XX*X*XXX*****X*X**X**X***XXX***X***X**X*X*
*X*XX**X***X***XX**X**XX**X*X***XXX***X**X*X*X*X*X***X**XX*X*****X*X*XX**XX***X*X*X***X*XXX*X**XX*X*
*X*X**X**X**X*X*X*X**X*X*XXX**X****X*XX*X*X**X**XX*XX*X**X**X*XX**XX*X**X**X*X**X***X*X**X*XX*X***X*
*X*X*XXXX**X****X**X*X*X**X**X**X*X*****X*X*X**X***X**XX***X**X*X*X**X*X**X***X*XXX*X**X*X****X*XX**
*X*X**X***X**XX*X*X**X**X**X**X**X**XXXX**X**X*X*XXXX***XX**X*X*X***X***X***X******X*X*X**X*XX*****X
*X**X***XX**X*X*X*XX**X*X*XXX**X**X*X****XX*X**X***X**X****X**X***X*X*XX**XX*XXXXX******X*X*X**XXXX*
**X*XX*X**X*X***X**X*X*****X**XX*X****X*X***X*X*XX*X*X*XX*X**X**XX*X**X**XX*******X*X*XX**X*X*X*****
*X***X**X***XXX**X*X**XX*XX**XX***XXX**X**X**X*****X*X***X**X**X***X*XX*XX**X*X*XX*X**X**X**X*X*XX*X
**XX**XX**X****X*X**X*X***X*X***XX****X**X*X**XX*XXX***XXX*X**XXX*X**X*****X***X****X**X*XX*X*X*X**X
X*X**X***X*XXX*X**X***X*X*X*X*XX*X*XXX*X*X***X***X**X*X****X*X*X***X**XXXXX**X*X*XX*XX*X****X*X*X*XX
X*X*XX*XX****X**X*XX*XXX**X*X**X*X*X***X*X*XX**XX*X*X**X*XX**X***XX**X*****X**X**XX***X*XXXX**X*X**X
**XXX**X**XX**X*X**XX*X**X**XX***X*X*X*X*XX*X*X***X**X*X*X**X*X*XXX*XX*X*X**X**X***XX*X****XX**XXX**
*X****X**X**X*X**X****X*X*X**X*X*X*X*X*X****X***X**X***X**X*****XX**X**XX**X**XXXX**X**X*X***X**XX*X
*X*X*X*X*X*XXXX*X*X*X*X*X**X**X**X**X***XXX**XXX*X**X*X*X**X*X*X***X**X*X*X*X**X**X*XX*X*X*X**X*****
*X**X*******X***X**X*X**X*X*X*X*XXX**XX***X*X*****X**XX**X*X**X**X*X*X**X****X***XX**X*X**X*X**XX*X*
*XX*X*XXX*XX**X***X***X*****X*X**X*X*X*X*X**X*XX*XXX***X****XX**X**X**X**XXX**XX***X*X***X***X*X*X**
**X**X*****X*X*X*X**X**XX*X*X**X***X*X***X*X**X**XX*XX**X*X**X*X**X*X**X****X***XXX**XX*XX*X*X***X*X
X**X*XX*XX*X*X*X*X*X*X***X**XX*XX*X**XX*X***X**X******X*XXXX*X**XX****X**X*XXXX*X***X**XX**X**X*XX*X
*X*X**X**X*X*X***X****X*X**X*X**XX**X***X*XX**X*XX*XX*X***X**XX****XXX*X*X**X*X***XXXX****X*X*X*X**X
***XX***X**X**X*X*XXX*X**X***XX***X***X*X**X*XX**X**X**XX**X***X*XX**X****X****XXX**X*X*XX**X*X**X**
*X***X*X**X*X**XX*****XX**XX***XX**XXX**X*X*****X*X**X*X**X*X*X*X***X**XX**X*X****X******X*XX**X**X*
**XX**X**X***X*X**X*XX**X****X*X*X*X**X*X*X*XXX*X***X*X**XX******XX***XX**X*X**XX**X*XXX*X***X**X***
*X***X**X**X*X**X**X***XXXXXX*X******X**X*X*X****X*X****X***XX*X***XXXX**X**X*X*XX**XX***X*X**X**XXX
*X*X*X*X**X**XX*X*X**X**X*****X*XX*X*X*X**X**X*X*X**X*XX*X*X***X*X*****X**X*X*X***X****XX***X**X****
*X*XX**X*X**X*X***X*X*X***XX*X****X**X*X*X*X**XXX*X*X*X**X**XX**X*XXXX**X***X**XX**XXXX**X*X**X*XXX*
*X**X*X***X****XXX**X**XXX***X*X*X**X**X****X**X**X***X*X**X***X**X***X**XX**X*X*X*****X***X*X****X*
**X***XX*X*XX*X**X*X**X***X*X**XX**X**X*X*X**X*X*XXXXX***X*X*XX**X**X**X**XXX**X*X*XX*X**X*X**XXX*X*
X**XXX***X**X**X***X*X**XX**X*X***X**X**X**X*X*X**X***XX***X**X*X*X**X*XX***X*X****XX***XX**X***X*X*
**XX***XX**X**X*X*X****X***X***XXXX*X*X**X**X***X***X***X*XX*X*****X*X***XX*X*X*X*X**XXX**X*XXX***X*
X****XX**X*X*XX****X*X*XX*X*X*X*****X**X*XX**X*XXX*X*XX*XX***X*XX*X**XXX****X*XXX***XX***XX***X*X*X*
*XXXX**X***X***XX*X**XX***X*X***XXXX*X****X*X***X**X**X****XX****XX*X***XXXXX****XX***XX*X*XX*X**X**
*X***X*X*X**XX****XX**X*XX***XXX***X***XX*X*XX*X**X*X**XXXX***XXX***XXX******X*X***XX*X*****X**X*X*X
***X***X*X*XXXXXXX**X*X*XXXX*X***X**X*X*X*X******X***X****X*X***X*XX***X*X*X*X*XXX**X**XX*X**X*X*X*X
*X**XX*X*X**XX*****X*****X*****X*XX**X****XXXXX*X**X*X*X*X***XX*X*X**X*XX**X**X***X**X*X**X*X**XXX*X
XXXX******X****XXX***X*X***X*XX****X***XX******XXXX****X***XX*******X*****XXX***X***X****X***X******