*X***X*********X***X*******X**X******X******X***X******X***X***X***X****X**X****X***X*****XX**X*******X******X*X**X***X*****X***X***X********XX**X****X*****X********X**X****X*****X***X****X********X**
*X*XXX*X*XX*XX***X**XX*XXX**X*X*XXXX***X*X*X**X***XXXX*X*X***X***X**X*X**X***X*X**X*XXX*X***X***XXXXX**XX*X*X***X***X*X*X*X***X***X**XXXXX*X***X***XX***XXX*X*XXXX*X**X***X*X**X*X**XX***XX*X*XX*XXX**X*
*X******X***X*XXXXX*X**X***X****X***XX*X**X**X*X*X*****X*X*XX**XX*X***XX*X*XXX***XX***X**XX**XXX****XX****X*X*X**XX*X*X**XXX*X**XX*X*****X**XX**X*X*X*XX**X*X****X**X***XX**X*XX**X*XXX*X***X*X**X**X*X*
*X*X*XX**XX*X****XX***X*X*X**XXX**X***X*X**X*X*X**X*X*X**X*X**X****XX**X*X*X**XXX**XX***X**X*X***XX***X*XX**X**X***XX**X**X*X**X***XXXXX***X**X*X***X*X*X*X**X*XX**X*XXXX*X**X***X***XX*X*XXXX**X*X*X***
**X**X**X***X*XX***XXX**X**X*X***X*XX****X***X**X*XXXX**X**XXX**X*X**XX**X*X*X***X***XXX**X**X*XX**XX***X*X**X**XX****X**X**X*X**X******X*XXX*X**XXX**X****X**X***X**X*****X*X*XX**X****X***X**X**X*X*X*
X**XX**XX*XXX*X*XX****X**X*X*X*XX***XXXX**XXX**XX***X**X**X****XX*X*X***X**X***XX**X****X**X***XXX***XXX**XX*X*X**XXX*XX***XX**X**XX*XXX*X*X***X****X*X*XX***X**XX**X**X*XX**X***XXXXXXX*XX***X**X**X**X
*X*X**X***X******X*XX**X***X*****X*X****X***X*X**XX***X*X***XXX***X***XX**X**X*X**X*XX*XXX**XXX*X**X***X*X***X*X*X******X*X***X**X***X*****X*X**XXX***X*X*X*X**X***X**X**X**X**X***X***X***X*X*X***X*X**
*X**X**X*XXX*X*XX****X*X*XX*XXX*X****XX**XX*X***X**XX****XXX***X*X*X*X***X**X*XX*X***X*XX*X***X***X*XX***X*XX**X***XXXXX**X*XX**X*X*X**XX*X**XX***XXXX**X**X**X**X***X*X**X**XX**X*XX*X**X**X***X*X**X*X
**X**XX**XX***X***XX**X**X*****X**X*XX*X**X***X**X***XXX****X*X**X*X***X**X*X****X*X*X****X*X**X*X****XX*X***X*XX*X******X**X**X**X***X*****X*X*X*****X*XX***XXX**X*X***X**X***X*X**X***X*X**XX*****XX**
X**X**X*X***X*X*X**XXX**X**X*X**X*XX****X**XXXXX*X*X****XXX***X*X***XXX*XX**X*X*X**X**XX*X**X*X**X*XX**X**XX*X***X**XXX*X**X**X**X*X*X*X*X*X***X*XXXX*X**XX*X*X*X**X**X**X**XX**X*X*X*XX***X**X*X*X****X
*X**X***X*XX*X**X*X****X**X*X**X***X*X*X**X***X**X*XXX*X***X*X**X*X*X******XX**X**X*X**X***XXX**X**X*X**X****X*X**X*X**X**X**XXX****X***X*X**X******X**X****X****X**X**X*XX***X*X***X*X**XX*X**X***XXXX*
*XX**X*X**X**X*X**X*X*XX*X**X*XX*XXX*X*XX*X*X***XX***X*X*X****X*X*X***XXX*X***X**X***X**X*XXX**XX*X***X**XXXX**X*XX*X*X**X*X*XX**XX**XX***X*X*X*XXXXXX**XXXX**X*X**X**X****X*X***XX*X**X*X***X**XX*X****
****X*X**X**XX**X*X**X***X*X**X**X***X**X*X**XXXX*XX*X*X**X*XX**X**XXX**X*X*XX**X*X*X**X***X**X***X*X**X*****X*X****X*X*X**X****X**X***XX*****X*****X*X*X**X*XX***X**X*XX*X***XX*X***X*****XX*X****X*X*X
XX*XX**X***X**X*X*XX***XX****X**X**X*XX*X**X******X**X**XXX**X*X**X***X*X***X**X****X*X**XX**X**XX**X*X*XXXX**X**X*X**X**X**XXXX**X*XX***XXXX**XXXX***X***XX***XXX*X*X**X**XX****XXX**XXXX*****X*XXX*X**
*****X**XX***X**X***XXX*XX*XXX*X**XX**X*X*X*XXX*X*X*XXX****X*X**X**XX****X*X**X*X*X***X*XXX*X*X*X**XX******XX**X*XX**XX*X**X****X*****X*X****X*****XX**X*X**XX***X****X**X***XXXX****X****X*XX**X****X*X
*X*X***XXXXX**X*X*X*X******X****X*X**X**X******XX*X**X*XXX**X**X*X****XX**XXX*X*X**X*X**XX**X***X*X**XXXXX**XX*X****X***XX***XX**X*XXX**X*XX**XX*X***X*X***X*X*XX**XX*X*X*X*XX****XXXXX*X**X**X**XX*XX**
**XXXX*XXX**X*X**X**X*XXX*X**X*X**X*X**XX*XX*XX****X*X****X**X*X**XXXX**X**X**X*X*X*X*X****X*X*XX**X******X*****X*X*XX*X*X*XX***XX*****X**XXX***X*XX*X*X*X***X***X*XXX****X****XXX***X***X***X*X*X**X**X
X**X*X**X**X**XX**X*X****X**X**X*X*X**X***X**XX*XX*X*X*X*X*X***X*X*****X*X*XX*X*X*X****XXXXX*X*X*X**XX*X*X*XXXXX*XXX***X*X***XX*X**XXXX*X**X*XX*X***X**X**XXX*XX*X**X**XXX**XXX****XX**X**XXX**X***XXX*X
X*X***X*X*X**X**X*XX*XXX*X*XXXX**X*X*XX*X**X****XXXX*X*XX***XXX**X*XXX***X**X*X***XX*XX********X**X****X*X********X**XX***XX**X*X*X******X*X**X***X***X**X*****X**X*X*XX***X****XXX*X*X*X*****X*XXX*X**X
**X*XX****X*XX*X*******X*X**X***X**X***XXX**XXX**X***X**X*X****X*X****X*X**X**X*XX***X**XX*XXXX*X**XXX*X*X*X*XXXX**X*X**X***X*X***X*XX*X***X*X*XXX*XX**X***XXX***XX*X*X**XX*X*XX****X*X**XXX*X****X***X*
*XX***X*X*X****X*XXXXX*X**XXX*XX**X*XX**X*X*X**XX**XX*X****XXX****XX*X**X*X**X**X**X***XX**X*****X****X**X*X*X**X*X**X*X*XX****XXX***X**X*X****X****XX**XXX***XXX***X*X*X*****X**X*X**X*X**X***XX**XX*X*
*X**X**XX**XXX**X****X**X*X***X**X****X*X*****X***XX***X*XX***X*X**X*X*XX***X**X**X*X*X***X**XXX**X*X**X**XX**X*X**X*X*X**XXX*X***XX*XX**XXX*X**X*X**XX*X***X***X*XX**X*X*X*X*X*X***X*X***X*XXX**X****X*
*X*X*X***X*X**X**XX*X**XX***XX**X**XX*X*X*XX*X**XXX**X***X**X*X*XX*X*X***XXX**X**X***X*X*X**X***X*X**X*X*X***X***X***X*XX****X**X**X***X**X**X*X**XX**X***XX*X*X**X**XX*X*XX**X*XX*XX***X*X***X*XXXXXX**
**XX***X****X***X***X*X**XXX***XXX***X**X**X*X*XX***X*XXXXXXX*X**XXX*X*X***X*X**XXX*X****X*X**X*X***XXX**X*XX**X**XXXX**XX*X*X*X*X***XX*X*X*XX*X*X**X**XXX***X*X*XX*XX**X**X*X***X***XXXX**XX****X****X*
X*X**XX*X*X*X*XX**XXX**X****X*X*X**X***XXX**X**X**XX*****X*****X*****X**XX*X**X*XX**X*XXX***X*X**X*XXX**X**X**X*X*X***X**X*X**X***XXX***X*X***X**X*XXX*****XX**X*X**X**XXXX***XX*XXX*****X**XX*X**X*X***
***X*X***X*X****X****X***XX*X*X***X*XXXXXX*X**X*X*X**X*X***XXX**XXX*X*X**X**X*X****X**X*X*XX**X*X***X**X**X**X**X**X*X*X***XX*X*X*****X***X*X*X*X***X*XX*X**X*XX*X*X**X*X***X**X****XXXX*XX*****X*X**X*X
X*X**X*XX***XXX*X*XX**X*X***X*X*XXX****XX***X*X*X*X*XX**X*X***X*X**X***X**XX**X*X*X**X**X*X**XX*X*X**X***X**XXX***X*****XXX***XX**X*XX*XXX*X**X**XX****X**X*X*X**X*X*X****XX**X*XX*X***X***XXXX*X**X*X*X
***X****X*X***X*X**X*X**X*X***X*X***XX***XX*X*X***XXX**X*X**X*X***X**X*XX*X**X***X**X**XX*X*XX**X**X**X*X**XXXX*XX**X*XX***X*X***X*X***X*****XXX***X*XX**X*X**X*XX*X*XX*XX**X*X**X**X*XXXX*****X**XX*X**
*XX**XXX**X*X***XXX**X*X*X*XX*X**X*X**XX*X**X**X*X****X**X*X**XXX*X*X***X**X**XXX**X*X*X**X*X**X**X**X*X**X*XX***XX*X***XX*X***XX**X*X***XX*X*X*XX***X**X**X*X*****X**X*X**XX***X**X**XX**X*XX***X***X*X
*X**X****X*X*XXX***X*X*X****XX*X***XX**X**XX**X****XXX*X***XX***X*XX*XX**X**X****X*X****X*X**X*XX*X*XX***X****XX****XXX**X**XXX***X***XXX*X********XX**X*X*X**XX*X**X*X**X*X**X**X**X****X*X**XXX*X*X***
*X*X**XXX******X*X*X*X*X*XX****XXXX**X*XX***X*X*XXX****X*XX**XX*X*****XX*XX**XXX*X*X*XX*X**X*X**X*X***X*XXX*X*X**X*X***X***XX***X*X*XX****XXXXX*XXX*X*XX***XX*X**XX*X**X*X***X*X**X*X*X*X****X******X*XX
**XXX*X***X*X*X**X***X***X*X*X******X****XX***XX****XX***X**X****X*XX**X***X***X***X**X***X**XX*X**XX****X**X*X*X*X**X*X*X*X**X*X*X*X**XX******X****X*X**X**X*X*X**X**X**X*XX***XX**XX***X*X*X*X*X*X***X
X**X**X*X*X*X***X**XX*XXX***XXXX*XXX**X*X**XXX***XXX*XXXX*X**X*X**X*X*X**X**XX*XXX*X*X**XX*X**X**X*X**XXX**X**X***X*X***X**X*X**X*X*X*X**XXXXX**XX*XX***X**X**X*X*X**XXX*X****XX***X***XX***X**X**XXX*XX
*X**X**XX*X**XXX*X****X***X**X*X*X***XX**X*****XX*********X*XX**X***X**XX**XXX****X***XX****X*X*X**XXX***X**X*XXXX**XX*X**XX**X*X*X****X******X*X****X*X**X**X****X*X*XX**X*XX***XX*XX**X*X*X*XXX**X***X
*XX**X*X**X*X**X**XX*X**X**X***X***XX**X***XX*X***XXX*XXX*X***X**XX**X*X**X*X*XXX**XX***X*X***X**X***X*X**X*X****X*X*X**X***X*X**X*XXXX**XX*X*X**X*X*X**X**X**XX*X**X****X***X*XX****X*X**X*X**X*X**X*XX
***X***X*X**XX***XX**XXX*X**XX**XXXX**XXXXX**X**XX****X*X*X*X*XX**X*X***X********X**XXX*X**XX**X**XX***XX*X**XXX***X**X**XXX**XX*X******X****XXX**X***X**X**X***XX*X*X*XX**XX**X**XX*X*X*XX**X***X*X***X
X*XX*XXXXX*X***X*X**X****XX***X*X****XXX****XX*X**X*XX**X*X*X***X*X*X*X*X*XXX*XX**X*****XX*X**X*X***XXX****X****XXX**X*X***X*X*X***XX*XX*X*X**X**XX*X*X*X**X**XX***X*****X*X**X**X***X***X*X**XX*X*X*X**
**X**X*X***X*XXX**X***XX***XX*X**X*X**X**X*XX***X*X***X*X****XXX***X**XX*****X***X*XXX*X*XX**XX**XX*X*X*XX*XXX*XX**X****XX*X****XXX*X*****X**X**X***X*X*X*X**X***XX*X*X*X**X*XXX**X*X**XX***X****X**X**X
X*X*X****X*X*X**X**XXXX*X*X***X*X***X**X*X*X**X***X*XX***XX*X****XX**X***XXXX**X*X****X***X*X***X*X***X*X****X***X***XX**X**XX*XX****XXXX**XX**X**XX**X*XXX*X**XX***X**X**X**XX**X***X****X**X*X**X*X*XX
****X*X*XXX**XX**X******X***XX**XX*X*X*X*X***X**XX**X**X****X*X*XX**X**XX*****XX***XX**XX***X*X****XX*X**XXX**XX***XX***X*X**X***X*X*X***X***X***X*X*XX*****X*X***X*X*X**X*X****X*XX**X*XX*X**X**X**X*XX
*XXX*XX**X**X***X*X*X*X**X*X***X***X*X**XX*XX**X*X*X**X*XX*X***X***X*XX***XXXX**XXX**X*X**X*X**XXX*X**XX***X*XX*X*X*X*XXX**X**XX*XX****X**XX**XXX****X*XXXXX**XX*X**X*X*X***X*XX****X**X***X*X**XX*XX**X
********X**X**X***X*X**XX*X**XX**X*X**X***XX**X**X**X*X***X*X*X**XX*****XX****X****X*X**X*X**X*X*X**X***XX*X*****XX*X*X***X*X*XX***XX*XXX***X*X**X*X*X*X*****X****X***X***X**X*X*XX**X***X*XX**X***X**XX
XXXXX*XX*X*X*X*XX*X*X*X***X*XX**X**X*XXXX*X**X**XXX*X**XX***X***X*X*X*XX***XXX**XX*****X***X*X*X*X*X*X*X*X**XXXX****X*XX*XX*X***XX***X*X*X*X****XX**X***XXX*X*X*X**X*X*X*X*X***X**X*X*XXX****X**X*X**X*X
*****X*X***X*X***XX**X**X*X***X**X*X**X***X*XX*XXXX**X*X*X*X*X*X****X*X**XX***X***XXXXX**X*X*X*X*****X*X*X*X****XXX*X**X*****X*X**XX*X***X*X*X*X***X**X*****X***XX**X***X***X*XXX*X******X*X**XX**XX*X**
*XXX*****XXX***X***X***X**XXX*X*X**X*X**X*X*X***XX**XX*******XX**XXX**X*X***X**X*X*****XX**X*X**X*XX*X***X**X*X*****X*X**XX*X****XXX***X*X**XX***XXX*X*XX*X*X*XX**X***X*X*X****X**XXXXXX**XXX****X***XX*
****XXXXX****XX*XX**XXX*X*****X*X*X***X**X****XX***X**XXXXXX***X*X***X***X*X*X*X*X*XXX*X**X**XX**X*XX*XX**X*X*XXXXXX**X*X**X**XX**X*XXXX**X***XXX****X***X*X**X**XXXXX**X**XXX*X*X******X**X*XXXX*X*X***
*X*X****X*X*X*****X*****XX*XXX*X**X*X**X**XX*X***XX*X*******XX**X**XXX*XX**X*X***X*X*X**XX**X***X*****X**X**X******X*X****XX*X**X*X*****X*XX*X***XX*X**X***X*XX*X*X***X**X*X**X**XX*X*X**X******X***X*X*
**X**XX**X**X*XX*X*X*XX***XX*****X**X*X*X**X**X*X*X***X*X*X***X**X*X***X**X***XXX**X**X***X*X*X***XXX***X*X**X*X*XXX***X*X***X*X***X*X*XX**X***X**X*X*XXX*XX*X*****X*X**XX***X**X****X*X**XX*XX*X*XX**X*
X***X**X*X*X**X**X*X*X*XX***X*X*X*X*X****X*XX*X*X**X*X**X**XX**X*X**X*X**XX*X*X***X**X*XX***X**XXX***XXX***X*X**X***XXX***X*X***X*XX*X***X***XXXX*X*X*XX**X**X*XXX***XX*X*XX**X*X*XXX***X**X*X**X***X*X*
*XXX**XX*X**X*X*XX***X**XXX*X*X*X**X**XX*X**X*X**X**X**X*X*X**XX*X*X***X*X**X*X*X**X*X***XXX**X**X*X*****X*X**XX**X***X*X*X*X*X*X****X*X*XXXX**X**X**X***X**X**X**XX**X*X****X**X*X***X**X*X**XX*XX**X**
*****XX***X*X*X****XX*X***X*X*X**X***X****X*X*X*X*X***XX*X**XX***X**X*XX*X*XX*X*X*X**X*X****X**X****XXXX**XXX*XX*X*XX***XX**X*X*XXXX*X**X***XX***X*X*X*X*X*X*X*X*X**X*X*X*XXX**X**X*X**XX**X*X*****X*XX*
*XXX****X*X*X*X*XXX*X***X*X*X*X*XXX*X**XX*X**X**X*X*XX****X**X*XX**X*****X*X**XX***X*X**XX*X*X**X*X*X***X**X*****X***X*X*X*X**XX***XX**X**X**X*XX****X**XX*X***X***X**X**X****X**X***XX***XX***X*X*X****
***XXX*X*X**X**X****X*X*X***X*X**X**X*XX**X*X**X**X*X*X*X*X*XX***X*XX*X*X**X*X***XX***X**X*X**X**XX*X*X**X**XX*XX**X**X**X*X*X***X****X**XXX*X***XX*X*X*X**X*X*X*X***X*X**X*XXXX*X*X**X*XX**XXX**X**XX*X
XX****X***X**X*X*X*X**XX*XXX*X*X**X**XX**X****X*X***X***X*X***XX*X***X****X***X*XX**X***XX***XXX*X**X**X*XX***XX**XXX*X*X**X*X*XXXXXX**X**X***XX**X*X***X*XX*X*XX*XX***X*X**X*X***X*X*X***X****XX*X*XX**
**XXX***X**X*X*X*X***X*****X*****X*X*X**X*XXXX**X*XX*X*XX*X*X**X*X*X*X*X*X*X*XX*X**X*XXX**XX**X**X*XXX*X***XX****X*X**X**X*X*****X***X**X*X*XXX*X*X**X*X**X**X******X*X**X*X****X*X****XX*X*XX****X****X
X****X*X**X**X*X**XXXXX*XX*XX*XXX*****XX******X***X****X**X*X*X**X*X**X*X**X****X*X*****X***X*X*X***X**XXX***X*XX**X*X**XX**X*X*X**X**XX**X*****X*X*X***X**X**XXX*X**X**XX*X*X*X***X*X****X*XXX*X**XXXXX
**X*X*X*X**X*X*XX****X***X**X*X*X*XXX**X*X*XX**XX**X*XX*X*X*X*X*X**XX****X**XXXXX**XX*X***X*X*X*X*XX**X****X*X*X*X*X**X***X**X**X*X*X***X**X*X*XX***X*X**X**X****XX*X**X***XX*X**X*X*XXXXXX**X*X*X*X***X
X*X*X****X*X*X***XXX**X*X*X***X***X**X*X**X**X***X***X**X*X*X*X**X***XXX*X*X*****X***X**X*X*X*X*XX***XX*X*X*X**X***X*X**X*X*X**X**X**XX***X*XX***XXX**X*X**X*X*XX***XX*X*XX****X*X*X*******X*X*****X*X*X
**X***X*X**X**X*X***X***X*XXXX*X*X*X*X*XX**X**XX**XXX**X**X*X**X**X*XX***X***XXX**XX**X*X*X*X****X*XX***XX****X**X***XX**X***XX**X**X**XXX****XX****X*X**X*X**X***X**X*****X*X**XX**X*XXXX*X*X*X*XX*X**X
X**XX*X***X*X*X*X*X**XXX*****X*X***X*X***X**X***X****X*X*X**XX*X*X*X***XX**X*X**X*XXX*X*X*X**XX*X**XX*XX***X*X**XX*XX**X**X*X***XX*X**X***X*X***XX*X**X*XX***X**X*XX**X*X*X***X*X**X*X***X*X**X***X***X*
**XX*X*XXX***X**X*X*X***X*XX****XX*X**X*XX*XX*X*XXXX***X*XX***X******XXX**X***X*X**X***X**XX***X**X*****XXX**X*XX***XX***X**X*XXX***X***X**X*X*X*X*X*XX***X*X**XX***X**X*X**XX****XX***X*X*XX*X*X**X*XX*
X**********X***XXX****X*****XXX******X********X*****XX*****XX***XXXXX****XXXX****X***X***X***X***XXXXXX*****XXX***X****XXXX*******X***XXXX*******X*****XX*****X***XXXX*****X***XXX***XX********XXX******